50 50 
100 100
1 1 1 1 1 1 1 1 1 1 1 1 1 1 1 1 1 1 1 1 1 1 1 1 1 1 1 1 1 1 1 1 1 1 1 1 1 1 1 1 1 1 1 1 1 1 1 1 1 1
1 0 0 0 0 0 0 0 0 0 0 0 0 0 0 0 0 0 1 0 / 0 0 C 0 0 K 1 - + 0 0 0 0 0 0 0 P 0 1 / 0 0 0 0 0 0 0 K 1
1 0 0 1 1 1 1 1 1 1 1 1 1 1 0 0 0 0 1 0 0 0 0 C 0 0 T 1 0 0 0 0 0 1 0 0 0 1 0 1 C 0 0 0 0 0 0 + - 1
1 0 0 1 L 0 0 0 0 0 0 0 0 1 0 0 0 0 1 0 0 0 0 C 0 0 0 1 0 0 1 1 1 1 1 1 1 1 0 1 C 0 0 T 0 + 0 0 W 1
1 0 0 1 1 1 1 0 0 0 0 0 0 1 0 0 0 0 P 0 + 0 0 C 0 0 0 1 0 0 1 0 0 0 0 0 0 1 0 1 C 0 0 0 + - + 0 W 1
1 0 0 1 1 1 1 1 1 1 1 0 0 1 1 1 1 1 1 + - + 0 0 0 0 0 1 0 0 1 1 0 0 1 1 0 1 0 1 C 0 0 0 0 + 0 0 - 1
1 0 0 1 1 0 0 0 0 0 0 0 0 1 0 0 0 0 1 0 + 0 0 0 0 0 0 1 W 0 0 1 1 0 0 1 0 1 0 1 0 0 0 0 0 0 0 R R 1
1 0 0 1 1 0 0 1 0 1 0 0 1 1 0 0 1 0 1 S 0 0 0 0 0 0 0 1 W 0 0 0 0 0 0 1 0 1 0 0 0 0 0 0 K 0 0 0 - 1
1 1 0 1 1 0 1 1 1 1 1 1 - 1 0 0 1 0 1 1 1 1 1 1 1 1 1 1 1 1 1 1 1 1 1 1 0 1 1 1 1 1 1 1 1 1 1 1 1 1
1 1 0 0 1 0 0 0 0 0 0 0 0 1 0 1 1 0 1 0 0 0 0 0 0 0 1 0 + - + 0 0 1 0 0 0 1 0 0 0 1 C 0 0 0 0 0 0 1
1 1 0 0 1 1 1 1 1 1 0 1 1 1 0 1 1 0 1 + + + + 0 0 0 1 0 0 0 0 0 0 1 0 0 0 P 0 0 0 1 C 0 1 0 1 0 / 1
1 1 0 0 0 0 0 0 0 0 0 0 0 0 0 1 1 0 P 0 0 0 0 0 0 0 0 0 0 0 0 0 0 1 0 0 0 1 0 0 0 1 0 0 1 1 1 0 0 1
1 1 0 0 0 0 0 0 0 0 0 1 1 1 1 1 0 0 1 + + + + 0 0 0 0 0 + - + 0 0 1 0 0 0 1 0 0 0 1 0 0 0 1 0 0 0 1
1 1 0 0 0 0 1 1 1 1 1 1 1 0 0 0 0 1 1 1 1 1 1 1 1 1 1 1 1 1 1 0 0 1 0 0 0 1 0 0 1 1 0 0 0 1 0 0 0 1
1 1 1 1 1 1 1 1 1 1 0 0 0 0 0 1 1 K 1 - + 0 0 0 0 0 0 0 0 K 1 0 0 1 0 0 0 1 0 0 1 + 0 0 0 1 0 0 0 1
1 1 1 1 1 1 1 0 0 0 0 0 0 0 0 1 1 0 1 + 0 0 0 0 0 0 0 0 0 / 1 0 0 1 0 0 0 1 0 0 1 + 0 0 0 1 0 0 0 1
1 1 1 0 0 0 0 0 1 1 1 1 1 1 1 1 0 0 1 0 0 1 1 1 1 1 1 1 1 1 1 0 0 1 0 0 0 1 0 0 1 1 0 0 + 1 0 0 0 1
1 1 0 0 0 1 1 1 1 1 1 1 1 1 1 0 0 0 1 C 0 0 0 0 0 0 0 0 0 0 0 0 0 0 0 0 + 1 0 0 0 1 0 0 - 1 0 0 0 1
1 1 0 0 0 0 0 0 0 0 0 0 0 0 0 0 0 1 1 C 0 0 0 0 0 0 0 0 0 0 0 0 0 0 0 + - 1 0 0 0 1 0 0 + 1 0 0 0 1
1 1 1 1 1 1 1 1 1 1 1 1 1 1 1 1 1 1 1 1 1 1 1 1 1 1 1 1 1 1 1 1 1 1 1 1 1 1 0 0 0 1 0 0 0 1 0 0 0 1
1 - + 0 0 0 0 0 0 0 1 C 0 0 0 0 0 0 0 0 0 0 0 1 1 1 1 / 0 0 0 0 0 0 0 0 0 1 0 0 0 1 0 0 0 1 1 0 0 1
1 + 0 0 0 0 1 0 0 0 1 C 0 0 0 0 0 0 0 0 0 0 0 0 1 1 1 0 0 0 + + + + 0 0 0 P 0 0 0 1 0 0 0 1 1 0 K 1
1 0 0 0 0 1 1 1 0 0 1 C 0 0 1 1 1 1 0 0 0 1 1 0 0 1 1 0 0 + - - - - + 0 0 1 0 0 0 1 0 0 0 0 1 1 1 1
1 0 0 0 1 1 1 1 0 0 1 C 0 0 1 0 0 1 1 0 0 0 1 0 0 0 1 0 0 + - - - - + 0 0 1 0 0 0 1 0 0 0 0 0 0 0 1
1 0 0 1 1 1 1 0 0 0 1 / 0 0 1 0 0 0 1 1 0 0 1 1 0 0 1 0 0 + - - - - + 0 0 1 0 0 1 1 0 0 0 1 0 0 0 1
1 0 0 0 1 1 1 0 0 0 1 0 0 0 1 0 0 0 0 1 0 0 0 1 1 K 1 0 0 + - - - - + 0 0 1 0 0 0 1 1 0 0 1 1 0 0 1
1 0 0 0 0 1 1 0 0 0 0 0 + 0 1 1 0 0 0 0 0 0 0 0 1 1 1 0 0 0 + + + + 0 0 0 1 0 0 0 0 1 1 1 1 1 1 0 1
1 0 0 0 0 1 1 0 0 0 0 + - + 1 1 1 0 0 0 0 0 0 0 0 1 1 0 0 0 0 0 0 0 0 0 + 1 0 0 0 0 0 0 1 0 0 0 0 1
1 1 0 0 0 0 1 R R 0 0 0 + 0 1 1 1 1 0 0 0 0 0 0 0 0 0 0 0 0 0 0 0 0 0 + - 1 + - + 0 0 0 0 0 0 0 0 1
1 1 1 0 0 0 1 1 1 1 1 1 1 1 1 1 1 1 1 1 1 1 1 1 1 1 1 1 1 1 1 1 1 1 1 1 1 1 1 1 1 1 1 1 1 1 1 1 1 1
1 1 1 0 0 0 1 1 1 0 0 0 0 0 0 0 W 0 0 / - - - 0 0 0 0 + + 0 0 1 1 1 0 0 0 1 0 0 0 0 0 1 1 1 0 0 0 P
1 1 0 0 0 0 1 1 1 0 0 0 0 C 0 0 W 0 0 0 0 0 0 0 0 0 + - - + 0 1 1 0 0 1 0 P 0 0 0 0 0 1 1 0 0 0 0 1
1 0 0 0 0 0 1 1 1 T 0 0 0 C 0 0 0 0 0 0 0 0 0 0 0 0 + - - + 0 1 0 0 1 1 1 1 0 0 + 0 0 1 1 0 0 0 0 1
1 0 0 0 0 0 1 1 1 0 0 0 0 C 0 0 0 1 1 1 1 1 1 1 0 0 + - - + 0 1 0 0 0 + - 1 0 + - + 0 1 0 / 0 0 1 1
1 0 0 0 0 0 1 1 1 0 0 0 0 C 0 0 0 1 0 0 0 0 0 0 0 0 + - - + 0 1 C 0 0 0 + 1 0 0 + 0 0 1 0 0 0 1 1 1
1 0 0 0 0 0 1 1 1 1 1 1 1 1 1 1 1 1 0 0 + 0 0 + 0 0 + - - + 0 1 C 0 - 0 T 1 0 0 0 0 0 1 0 0 1 1 1 1
1 W 0 0 0 0 0 0 0 0 0 0 0 0 0 0 1 1 0 0 - 0 0 - 0 0 + - - + 0 1 C 0 0 0 / 1 0 0 0 0 0 1 0 0 1 1 1 1
1 W 0 0 0 0 0 0 0 0 0 0 0 0 0 0 1 1 0 0 + 0 0 + 0 0 0 + + 0 0 1 C 0 0 0 0 1 1 1 1 1 0 1 0 0 1 1 1 1
1 0 0 0 0 - - - 0 0 0 0 0 0 0 0 0 0 0 0 0 0 0 0 0 0 0 0 0 0 0 1 0 0 0 0 0 1 - + 0 0 0 1 0 0 1 1 1 1
1 0 0 0 0 + + + 0 0 0 0 0 0 0 0 0 0 0 0 0 0 0 0 0 0 0 0 0 0 0 1 1 0 0 0 0 1 + 0 0 0 0 1 0 0 + 1 1 1
1 1 1 1 1 1 1 1 1 1 1 1 1 1 1 1 1 1 1 1 1 0 0 C 0 0 0 T 0 0 1 1 1 1 1 1 0 1 0 0 0 0 1 1 0 + - 0 1 1
1 S 1 R R 0 0 W W W W W W W 0 0 0 1 1 1 0 0 0 C 0 0 0 0 0 1 1 1 1 0 0 0 0 1 0 1 1 1 1 1 0 0 0 0 0 1
1 0 1 R R 0 0 W W W W W W W 0 0 0 1 1 0 0 C 0 0 0 1 1 1 1 1 1 1 0 0 0 0 0 1 0 0 0 0 1 1 1 0 0 0 0 1
1 0 1 R R 0 0 0 0 0 0 0 0 0 0 0 0 1 0 C 0 C 0 1 1 1 + 0 0 0 1 1 W W 0 W W 1 0 0 0 0 0 1 1 1 1 0 0 1
1 0 1 R R 0 0 0 + + 0 0 C 0 0 0 0 1 0 C 0 0 0 1 1 0 0 0 1 0 0 1 W W 0 W W 1 0 0 C 0 0 0 0 1 1 0 0 1
1 0 1 R R 0 0 = - - + 0 C 0 0 0 0 1 0 0 0 0 1 1 0 0 0 1 0 0 0 1 0 0 0 0 0 1 0 0 C 0 C 0 0 0 1 0 0 1
1 0 1 R R 0 0 + - - + 0 C 0 0 0 T 1 0 1 1 1 1 0 0 0 1 1 + - 0 1 0 0 0 0 0 1 1 0 0 0 C 0 C 0 1 0 0 1
1 0 0 R R 0 0 0 + + 0 0 C 0 0 0 0 P 0 0 1 0 0 0 0 1 1 1 1 + 0 0 0 0 0 0 1 1 1 1 0 0 0 0 C 0 0 0 0 1
1 0 0 0 0 0 0 0 0 0 0 0 0 0 0 0 0 1 1 0 0 0 0 0 1 1 1 1 1 1 0 0 0 0 0 1 1 1 1 1 1 0 0 0 0 0 0 0 + 1
1 1 1 1 1 1 1 1 1 1 1 1 1 1 1 1 1 1 1 1 1 1 1 1 1 1 1 1 1 1 1 1 1 1 1 1 1 1 1 1 1 1 1 1 1 1 1 1 1 1

0 = lantai
1 = tembok
K = kunci
L = lilin DONE
S = senjata DONE
- = meja
+ = kursi
R = ranjang 1x2
W = lemari 2x1
/ = kulkas
T = tv
C = sofa 2x1
* = MEJA YANG ADA KUNCI (RAHASIA)