50 50 
100 100
1 1 1 1 1 1 1 1 1 1 1 1 1 1 1 1 1 1 1 1 1 1 1 1 1 1 1 1 1 1 1 1 1 1 1 1 1 1 1 1 1 1 1 1 1 1 1 1 1 1
1 0 0 0 0 0 0 0 0 0 0 0 0 0 0 0 0 0 1 0 / 0 0 C 0 0 K 1 - + 0 0 0 0 0 0 0 P 0 1 / 0 0 0 0 0 0 0 K 1
1 0 0 1 1 1 1 1 1 1 1 1 1 1 0 0 0 0 1 0 0 0 0 C 0 0 T 1 0 0 0 0 0 1 0 0 0 1 0 1 C 0 0 0 0 0 0 + - 1
1 0 0 1 L 0 0 0 0 0 0 0 0 1 0 0 0 0 1 0 0 0 0 C 0 0 0 1 0 0 1 1 1 1 1 1 1 1 0 1 C 0 0 T 0 + 0 0 W 1
1 0 0 1 1 1 1 0 0 0 0 0 0 1 0 0 0 0 P 0 + 0 0 C 0 0 0 1 0 0 1 0 0 0 0 0 0 1 0 1 C 0 0 0 + - + 0 W 1  0 = lantai
1 0 0 1 1 1 1 1 1 1 1 0 0 1 1 1 1 1 1 + - + 0 0 0 0 0 1 0 0 1 1 0 0 1 1 0 1 0 1 C 0 0 0 0 + 0 0 - 1  1 = tembok
1 0 0 1 1 0 0 0 0 0 0 0 0 1 0 0 0 0 1 0 + 0 0 0 0 0 0 1 W 0 0 1 1 0 0 1 0 1 0 1 0 0 0 0 0 0 0 R R 1  K = kunci
1 0 0 1 1 0 0 1 0 1 0 0 1 1 0 0 1 0 1 S 0 0 0 0 0 0 0 1 W 0 0 0 0 0 0 1 0 1 0 0 0 0 0 0 K 0 0 0 - 1  L = lilin DONE
1 1 0 1 1 0 1 1 1 1 1 1 - 1 0 0 1 0 1 1 1 1 1 1 1 1 1 1 1 1 1 1 1 1 1 1 0 1 1 1 1 1 1 1 1 1 1 1 1 1  S = senjata DONE
1 1 0 0 1 0 0 0 0 0 0 0 0 1 0 1 1 0 1 0 0 0 0 0 0 0 1 0 + - + 0 0 1 0 0 0 1 0 0 0 1 C 0 0 0 0 0 0 1  - = meja
1 1 0 0 1 1 1 1 1 1 0 1 1 1 0 1 1 0 1 + + + + 0 0 0 1 0 0 0 0 0 0 1 0 0 0 P 0 0 0 1 C 0 1 0 1 0 / 1  + = kursi
1 1 0 0 0 0 0 0 0 0 0 0 0 0 0 1 1 0 p 0 0 0 0 0 0 0 0 0 0 0 0 0 0 1 0 0 0 1 0 0 0 1 0 0 1 1 1 0 0 1  R = ranjang 1x2
1 1 0 0 0 0 0 0 0 0 0 1 1 1 1 1 0 0 1 + + + + 0 0 0 0 0 + - + 0 0 1 0 0 0 1 0 0 0 1 0 0 0 1 0 0 0 1  W = lemari 2x1
1 1 0 0 0 0 1 1 1 1 1 1 1 0 0 0 0 1 1 1 1 1 1 1 1 1 1 1 1 1 1 0 0 1 0 0 0 1 0 0 1 1 0 0 0 1 0 0 0 1  / = kulkas
1 1 1 1 1 1 1 1 1 1 0 0 0 0 0 1 1 K 1 - + 0 0 0 0 0 0 0 0 K 1 0 0 1 0 0 0 1 0 0 1 + 0 0 0 1 0 0 0 1  T = tv
1 1 1 1 1 1 1 0 0 0 0 0 0 0 0 1 1 0 1 + 0 0 0 0 0 0 0 0 0 / 1 0 0 1 0 0 0 1 0 0 1 + 0 0 0 1 0 0 0 1  C = sofa 2x1
1 1 1 0 0 0 0 0 1 1 1 1 1 1 1 1 0 0 1 0 0 1 1 1 1 1 1 1 1 1 1 0 0 1 0 0 0 1 0 0 1 1 0 0 + 1 0 0 0 1  * = MEJA YANG ADA KUNCI (RAHASIA)
1 1 0 0 0 1 1 1 1 1 1 1 1 1 1 0 0 0 1 C 0 0 0 0 0 0 0 0 0 0 0 0 0 0 0 0 + 1 0 0 0 1 0 0 - 1 0 0 0 1
1 1 0 0 0 0 0 0 0 0 0 0 0 0 0 0 0 1 1 C 0 0 0 0 0 0 0 0 0 0 0 0 0 0 0 + - 1 0 0 0 1 0 0 + 1 0 0 0 1
1 1 1 1 1 1 1 1 1 1 1 1 1 1 1 1 1 1 1 1 1 1 1 1 1 1 1 1 1 1 1 1 1 1 1 1 1 1 0 0 0 1 0 0 0 1 0 0 0 1
1 - + 0 0 0 0 0 0 0 1 C 0 0 0 0 0 0 0 0 0 0 0 1 1 1 1 / 0 0 0 0 0 0 0 0 0 1 0 0 0 1 0 0 0 1 1 0 0 1
1 + 0 0 0 0 1 0 0 0 1 C 0 0 0 0 0 0 0 0 0 0 0 0 1 1 1 0 0 0 + + + + 0 0 0 p 0 0 0 1 0 0 0 1 1 0 K 1
1 0 0 0 0 1 1 1 0 0 1 C 0 0 1 1 1 1 0 0 0 1 1 0 0 1 1 0 0 + - - - - + 0 0 1 0 0 0 1 0 0 0 0 1 1 1 1
1 0 0 0 1 1 1 1 0 0 1 C 0 0 1 0 0 1 1 0 0 0 1 0 0 0 1 0 0 + - - - - + 0 0 1 0 0 0 1 0 0 0 0 0 0 0 1
1 0 0 1 1 1 1 0 0 0 1 / 0 0 1 0 0 0 1 1 0 0 1 1 0 0 1 0 0 + - - - - + 0 0 1 0 0 1 1 0 0 0 1 0 0 0 1
1 0 0 0 1 1 1 0 0 0 1 0 0 0 1 0 0 0 0 1 0 0 0 1 1 K 1 0 0 + - - - - + 0 0 1 0 0 0 1 1 0 0 1 1 0 0 1
1 0 0 0 0 1 1 0 0 0 0 0 + 0 1 1 0 0 0 0 0 0 0 0 1 1 1 0 0 0 + + + + 0 0 0 1 0 0 0 0 1 1 1 1 1 1 0 1
1 0 0 0 0 1 1 0 0 0 0 + - + 1 1 1 0 0 0 0 0 0 0 0 1 1 0 0 0 0 0 0 0 0 0 + 1 0 0 0 0 0 0 1 0 0 0 0 1
1 1 0 0 0 0 1 R R 0 0 0 + 0 1 1 1 1 0 0 0 0 0 0 0 0 0 0 0 0 0 0 0 0 0 + - 1 + - + 0 0 0 0 0 0 0 0 1
1 1 1 0 0 0 1 1 1 1 1 1 1 1 1 1 1 1 1 1 1 1 1 1 1 1 1 1 1 1 1 1 1 1 1 1 1 1 1 1 1 1 1 1 1 1 1 1 1 1
1 1 1 0 0 0 1 1 1 0 0 0 0 0 0 0 W 0 0 / - - - 0 0 0 0 + + 0 0 1 1 1 0 0 0 1 0 0 0 0 0 1 1 1 0 0 0 P
1 1 0 0 0 0 1 1 1 0 0 0 0 C 0 0 W 0 0 0 0 0 0 0 0 0 + - - + 0 1 1 0 0 1 0 P 0 0 0 0 0 1 1 0 0 0 0 1
1 0 0 0 0 0 1 1 1 T 0 0 0 C 0 0 0 0 0 0 0 0 0 0 0 0 + - - + 0 1 0 0 1 1 1 1 0 0 + 0 0 1 1 0 0 0 0 1
1 0 0 0 0 0 1 1 1 0 0 0 0 C 0 0 0 1 1 1 1 1 1 1 0 0 + - - + 0 1 0 0 0 + - 1 0 + - + 0 1 0 / 0 0 1 1
1 0 0 0 0 0 1 1 1 0 0 0 0 C 0 0 0 1 0 0 0 0 0 0 0 0 + - - + 0 1 C 0 0 0 + 1 0 0 + 0 0 1 0 0 0 1 1 1
1 0 0 0 0 0 1 1 1 1 1 1 1 1 1 1 1 1 0 0 + 0 0 + 0 0 + - - + 0 1 C 0 - 0 T 1 0 0 0 0 0 1 0 0 1 1 1 1
1 W 0 0 0 0 0 0 0 0 0 0 0 0 0 0 1 1 0 0 - 0 0 - 0 0 + - - + 0 1 C 0 0 0 / 1 0 0 0 0 0 1 0 0 1 1 1 1
1 W 0 0 0 0 0 0 0 0 0 0 0 0 0 0 1 1 0 0 + 0 0 + 0 0 0 + + 0 0 1 C 0 0 0 0 1 1 1 1 1 0 1 0 0 1 1 1 1
1 0 0 0 0 - - - 0 0 0 0 0 0 0 0 0 0 0 0 0 0 0 0 0 0 0 0 0 0 0 1 0 0 0 0 0 1 - + 0 0 0 1 0 0 1 1 1 1
1 0 0 0 0 + + + 0 0 0 0 0 0 0 0 0 0 0 0 0 0 0 0 0 0 0 0 0 0 0 1 1 0 0 0 0 1 + 0 0 0 0 1 0 0 + 1 1 1
1 1 1 1 1 1 1 1 1 1 1 1 1 1 1 1 1 1 1 1 1 0 0 C 0 0 0 T 0 0 1 1 1 1 1 1 0 1 0 0 0 0 1 1 0 + - 0 1 1
1 S 1 R R 0 0 W W W W W W W 0 0 0 1 1 1 0 0 0 C 0 0 0 0 0 1 1 1 1 0 0 0 0 1 0 1 1 1 1 1 0 0 0 0 0 1
1 0 1 R R 0 0 W W W W W W W 0 0 0 1 1 0 0 C 0 0 0 1 1 1 1 1 1 1 0 0 0 0 0 1 0 0 0 0 1 1 1 0 0 0 0 1
1 0 1 R R 0 0 0 0 0 0 0 0 0 0 0 0 1 0 C 0 C 0 1 1 1 + 0 0 0 1 1 W W 0 W W 1 0 0 0 0 0 1 1 1 1 0 0 1
1 0 1 R R 0 0 0 + + 0 0 C 0 0 0 0 1 0 C 0 0 0 1 1 0 0 0 1 0 0 1 0 0 0 0 0 1 0 0 C 0 0 0 0 1 1 0 0 1
1 0 1 R R 0 0 = - - + 0 C 0 0 0 0 1 0 0 0 0 1 1 0 0 0 1 0 0 0 1 W W 0 W W 1 0 0 C 0 C 0 0 0 1 0 0 1
1 0 1 R R 0 0 + - - + 0 C 0 0 0 T 1 0 1 1 1 1 0 0 0 1 1 + - 0 1 0 0 0 0 0 1 1 0 0 0 C 0 C 0 1 0 0 1
1 0 0 R R 0 0 0 + + 0 0 C 0 0 0 0 P 0 0 1 W W 0 0 1 1 1 1 + 0 0 0 0 0 0 1 1 1 1 0 0 0 0 C 0 0 0 0 1
1 0 0 0 0 0 0 0 0 0 0 0 0 0 0 0 0 1 1 0 0 0 0 0 1 1 1 1 1 1 0 0 0 0 0 1 1 1 1 1 1 0 0 0 0 0 0 0 + 1
1 1 1 1 1 1 1 1 1 1 1 1 1 1 1 1 1 1 1 1 1 1 1 1 1 1 1 1 1 1 1 1 1 1 1 1 1 1 1 1 1 1 1 1 1 1 1 1 1 1